NO   ./textures/wall-bricks-blue
SO    ./textures/wall-bricks-blue


WE ./textures/wall-bricks-blue
F 30,  60,90

C 70,130,180

EA ./textures/wall-bricks-blue

  110011 
 10000011 
  1100001
 1100N01 
  1100001
   11111 