NO ./textures/wall-bricks-brown.png
SO ./textures/wall-bricks-brown.png
EA ./textures/wall-bricks-brown.png
WE ./textures/wall-bricks-brown.png
F 150,150,150
C 125,125,125

111011
101001
100N01
100001
100101
111111
loll

