NO ./textures/wall-bricks-blue.png
SO ./textures/wall-bricks-brown.png
EA ./textures/wall-bricks-brown.png
WE ./textures/wall-bricks-brown.png
F 150,150,150
C 125,125,125

l
111001
101001
100N01
100001
100101
111111
loll