NO ./textures/wall-bricks-blue.png
SO ./textures/wall-bricks-brown.png
EA ./textures/wall-bricks-green.png
WE ./textures/wall-bricks-purple.png
F 150,150,150
C 75,75,75

111111
101001
100N01
100001
100101
111111
