NO   ./textures/wall-bricks-green.png
SO    ./textures/wall-bricks-green.png


WE ./textures/wall-bricks-green.png
F 5,119,2

C 32,224,36

EA ./textures/wall-bricks-green.png

  1111111111111111111111111111111111 
 100000000000000000000000000000011 
  1100000000000000111000000N0000111
 110000000000001111110000000000001 
  110000111100000000000000000000001
    111111111111000111111111111111
    1100000000000000000000000000111
   1100000000000000000000000000111
    1100000000000000000000000000111
 11111111111100011111111111111111
    1100000000000000000000000000111
  1100000000000000000000000000111
   1100000000000000000000000000111
    1111111111111111111111111111