NO   ./textures/wall-bricks-blue.png
SO    ./textures/wall-bricks-blue.png


WE ./textures/wall-bricks-blue.png
F 30,60,90

C 70,130,180

EA ./textures/wall-bricks-blue.png

1111111111111111
 1100000000000011
  100000S001100011
  111000001000011
   1000000000011
   1111D11110111
    11000001111
    111000001111
    1000000001
    1000000001
   1111D11110111
    110000010001
   1100000000011
   110000000011
  100000000110011
  11000110000001
   1000000000111
    1100111111
     1111